	     	
  F      220  , 100, 0        
  
    SO  ./textures/PIPES_2B.xpm 

  NO      ./textures/BRICK_1A.xpm  
 

 C   225, 30 , 0  

 WE   ./textures/WOOD_1C.xpm                 



            EA              ./textures/GRID_2B.xpm   


	

   1  111111  11
11101100000111001 
  11  111011  1111  
1100110111011110N011  1
11110111 11101000001 101
  11111111 11111111 11111                              
