	     	
  F      220  , 100, 0        
  
    SO  ./textures/PIPES_2B.xpm 

  NO      ./textures/BRICK_1A.xpm  
 

 C   225, 30 , 0  

 WE   ./textures/WOOD_1C.xpm                 



            EA              ./textures/GRID_2B.xpm   


	

  11     11                   
 1001   1001
1N00011100001
 11111111111111