	     	
  F      220  , 100, 0        
  
    SO  ./textures/PIPES_2B.xpm 

  NO      ./textures/BRICK_1A.xpm  
 

 C   225, 30 , 0  

 WE   ./textures/WOOD_1C.xpm                 



            EA              ./textures/GRID_2B.xpm   


	
1111111111111111111111111111111111111111111111
1000000000000000000000000000000000000000000001
1000000000000000000000000000000000000000000001
1000000000000000000000000000000000000000000001
1000000000000000000000000000000000000000000001
1000000000000000000000000000000000000000000001
1000000000000000000000000000000000000000000001
1000000000000000000000000000000000000000000001
1000000000000000000000000000000000000000000001
1E00000000000000000000000000000000000000000001
1111111111111111111111111111111111111111111111