F 112, 20, 242
C 82, 130, 172     	     	

NO textures/north.xpm
SO textures/south.xpm
EA textures/east.xpm
WE textures/west.xpm

  111         111  
 10001       10001
1000001     1000001
1000001     1000001
1000001111111000001
 11000000000000011
  111000000000111
    10001010001
   1100010100011
   1000001000001
   11E0000000011
    10010001001
    11001110011
     110000011
       11111
